$$$$$$$$$$$$$$$$$$$$$$$$$$$$$$$$$$$$$$$$$$$$$$$$$$$$$$$$$$$$$$$$$$$$$$$$$$$$$$$$$$$$$$$$$$$$$$$$$$$$$$$$$$$$$$$$$$$$$$
      $$$$$$$$$$$$$$$$$$$$$$$$$$$$$$$$$$$$$$$$       $$$$$$$$$$$                               $$$$$$$$$$$$$$$$$$$$$$$
$$$$$ $$$$$$$                               $$ $$$$$ $$$$$$$$$$$ $$$$$$$$$$$$$$$$$$$$$$$$ $$$$ $$$$$$$               $
$$$$$ $$$$$$$ $$$$$$$$$$$ $$$$$$$ $$$$$$$$$ $$ $$$$$                          $$$         $$$$ $$$$$$$ $$$$$$$$$$$$$ $
$$$$$ $$$$$$$ $$$$$$$$$$$ $$$$$$$ $$$$$$$$$ $$ $$$$$ $$$$$$$$$$$$$$$$$$$$$$$$ $$$ $$$$$$$ $$$$         $$$$$$$$$$$$$ $
$$$$$ $$$$$$$             $$      $$$$$$$$$ $$ $$$$$ $$$$$$$              $$$ $$$ $$$$$$$ $$$$ $$$$$$$ $$$$$$$$$$$$$ $
$$$$$ $$$$$$$ $$$$$$$$$$$ $$ $$$$ $$$$$$$$$             $$$$ $$$$$$$$$$$$ $$$ $$$ $$$$$$$ $$$$ $$$$$$$ $$$$$$$$$$$$$ $
$$$$$         $$$$$$$$$$$    $$$$ $$$$$$$$$ $$$$$$$$$$$ $$$$ $$        $$ $$$ $$$ $$$$$$$ $$$$                       $
$$$$$$$$$$$$$$$$$$$$$$$$$ $$$$$$$                     $ $$$$ $$ $$$$$$ $$ $$$ $$$ $$$$$$$$$$$$$$$$$$$$ $$$$$$$$$$$$$$$
$$         $$$$$$$$$$$$$$ $$$$$$$$$$$$$$$$$ $$$$$$$$$ $ $$$$ $$ $$$$$$$$$ $$$ $$$ $$$$$            $$$ $$$$$$$$$$$$$$$
$$ $$$$$$$ $$$$$$                    $$$$$$ $       $ $ $$$$ $$           $$$ $$$ $$$$$ $$$$$$$$$$ $$$ $$      $$$$$$$
$$ $$$$$$$ $$$$$$ $$$$$$ $$$$$$$$$$$ $$$$$$ $ $$$$$$$ $ $$$$ $$$$$$$$$$$$$$$$ $$$             $$$$ $$$ $$ $$$$ $$$$$$$
$$ $$$$$$$ $$$$$$ $$$$$$ $$$$$$$$$$$ $$$$$$ $         $ $$$$                  $$$$$$$$$$$$$$$ $$$$ $$$ $$ $$$$     $$$
$$ $$$$$$$ $$$$$$ $$$$$$         $$$ $$$$$$ $$$$$$$$$$$ $$$$$$$$$$$$$$$$$$$$$$$$$$$$$$$$$$$$$ $$$$ $$$ $$ $$$$ $$$ $$$
$$ $$$$$$$        $$$$$$$$$$$$$$ $$$ $$$$$$          $$ $$$                               $$$ $$$$ $$$ $$ $$$$ $$$ $$$
$$ $$$$$$$$$$$$$$$$$$$$$$$$$         $$$$$$$$ $$$$$$ $$ $$$ $$$$$$$$$$$$$$$$$$$$$$$$$$$$$ $$$          $$ $$$$ $$$ $$$
$$                      $$$$ $$$$$$$$$$$$$$$$ $$$$$$    $$$ $$$$$$$$$$$$$              $$ $$$ $$$$$$$$$$$ $$$$ $$$ $$$
$$$$$$$$$$$$$$$$$$$$$$$ $$$$ $$$$             $$$$$$ $$$$$$          $$$$ $$$$$$$$$$$$ $$ $$$ $$$$$$$$$$$ $$$$ $$  $$$
$$$$$$$$$$$$$$$$$$$$$$$ $$$$ $$$$ $$$$$$ $$$$$$$$$$$ $$$$$$ $$$$$$$$ $$$$ $$ $$$$$$$$$ $$ $$$                  $$$$$$$
$$                      $$$$ $$$$ $$$$$$         $$$        $$$$$$$$ $$$$ $$           $$ $$$$$$$$$$$$$$$ $$$$$$$$$$$$
$$ $$$$$$$$$$$$$ $$$$$$ $$$$ $$$$ $$$$$$$$$$$$$$ $$$ $$$$ $$$$$$$$$$ $$$$ $$$$$$$$$$$$$$$             $$$ $$$$$$$$$$$$
$$ $$$$$$$$$$$$$ $$$$$$ $$$$                         $$$$ $$$$$$$$$$ $$              $$$$$$ $$$$$$$$$ $$$          $$$
$$ $$$$$$               $$$$$$$$$$$$$$$$$$$$$$$$$$ $$$$$$ $$$$$$$$$$ $$ $$$$$$$$$$$$$ $$$$$ $$      $ $$$ $$$$$$$$$$$$
$$ $$$$$$ $$$$$$$$$$$$$ $$$$$$$$$$$$$$$$$$$$$$$$$$ $$$$$$     $$$$$$ $$ $           $ $$$$$ $$ $$$$ $ $$$          $$$
$$ $$$$$$ $$$$$$$$$$$$$                       $$$$ $$$$$$$$$$     $$ $$ $ $$$$$$$$$ $ $$$$$ $$ $$$$ $ $$$$$$$$$$$$ $$$
$$ $$$$$$       $$$$$$$$$$$$$$$$ $$$$$$$$$$$$ $$$$     $$$$$$ $$$ $$$$$ $$$$$$$$$$$ $ $$$$$ $$ $$$$ $$$$$$$        $$$
$$ $$$$$$ $$$$$ $$$$$$$$$$$$$$$$ $$$$$$$$$$$$ $$$$ $$$ $$$$$$ $$$ $$$$$             $ $$$$$    $$$$     $$$ $$$$$$ $$$
$$ $$$$$$ $$$$$ $$$$$$$$$$$$$$$$ $$$$$$$$$$$$ $$$$ $$$ $$$$$$ $$$ $$$$$$$$$$$$$$$$$$$ $$$$$ $$$$$$$$$$$     $$$$$$ $$$
$$                                                 $$$ $$$$$$ $$$                     $$$$$ $$$$$$$$$$$ $$$$$$$$$$ $$$
$$$ $$$$$$ $$$$$$$$$$$$$$$$$$$$$$$$$$ $$$$$$$ $$$$$$$$ $$$$$$ $$$$$$$$$$$$$$$$$$$$$$$$$$$$$ $$$         $$$$$$$$$$ $$$
$$$ $$$$$$ $$$$$$$$                   $$$$$$$ $$$$$$$$        $$                            $$$ $$$$$$$ $$$$$$$$$$ $$$
$$$ $$$$$$ $$$$$$$$ $$$$$$$ $$$$$$$$$$$$$$$$$ $$$$$$$$ $$$$$$$$$ $$$$$$$$$$$ $$$$$$$$$$$$$$$$$$ $$$$$$$ $$$$$$$$$$ $$$
$$$        $$$$$$$$ $$$$$$$ $$$$$$$$$$$$$$$$$ $$$$$$$$           $$$$$$$$$$$ $$$$$$$$$$$$$$$$$$ $$$$$$$            $$$
$$$$$$$$$$          $$$$$$$                            $$$$$$$$$$$$$$$$$$$$$                    $$$$$$$ $$$$$$$$$$$$$$
$$$$$$$$$$$$$$$$$$$$$$$$$$$$$$$$$$$$$$$$$$$$$$$$$$$$$$$$$$$$$$$$$$$$$$$$$$$$$$$$$$$$$$$$$$$$$$$$$$$$$$$ $$$$$$$$$$$$$$